AQUA	AE K W AH
AQUA(2)	AA K W AH
BLACK	B L AE K
BLUE	B L UW
COMPUTER	K AH M P Y UW T ER
GOLD	G OW L D
GRAY	G R EY
GREEN	G R IY N
INDIGO	IH N D AH G OW
INDIGO(2)	IH N D IH G OW
LIME	L AY M
MAGENTA	M AH JH EH N T AH
NAVY	N EY V IY
ORANGE	AO R AH N JH
ORANGE(2)	AO R IH N JH
PURPLE	P ER P AH L
RED	R EH D
WHITE	W AY T
WHITE(2)	HH W AY T
YELLOW	Y EH L OW
